################
#      @       #
#              #
#              #
#      X       #
#    L    L    #
#              #
#              #
#              #
#              #
#              #
#     ssssssss #
#              #
#              #
#         C    #
################
